###############################
##00000000000#00000000#000000G#
#0########0#0#0#00###0##0####0#
#0#00#00000#000##0#0000000#000#
#0##0#####0#0#000000#####000#0#
#00#0#000#0#00000000000000#0#0#
#00#0#0###0###########00###0#0#
#P000000000#000000000000000000#
###############################
